*********X
*XXXX*XXXX
*X********
*X*XXXXXX*
*X*XXX****
***XXXXXXX
*X***XX*XX
*XX*******
XX**XXXXX*
***XXXXXX*