BBBBBBBBBBBBBBBBBBBBBBB
.......................
.S............-------E.
.|............/........
.----|......../........
.....|......../........
.....|......../........
.....---------/........
.......................
