############
#        P #
#       ####
#          #
#######    #
#  X ##    #
#    ##    #
#          #
#       X  #
#       #  #
############
