############
#        O #
#       ####
#          #
#######    #
#  X ##    #
#    ##  P #
#          #
#X         #
#       #  #
############
