############
#       PX #
#       ####
#          #
#######    #
#  X ##    #
#    ##    #
#          #
#          #
#       #  #
############
